w w w w w w w w w w w w w w w w w w w w
w @ o o o ? w o o o o o o o o o o o ? w
w o o o o o o o o o o o w o o o o o o w
w o o o o o w o o ! o o o o o o o o o w
w o o o ! o o o o o o o w o ! o o o $ w
w o o o o o w o o ! o o o o o o o o o w
w o o o o o o o o o o o w o o o o o o w
w @ o o o ? w o o o o o o o o o o o ? w
w w w w w w w w w w w w w w w w w w w w