w w w w w w w w w w w w w w w w w w w w w w w w w w w w w w w w w w w w w w w w w
w o o o o o o o o o o o o w o o o o o o o o w o o o o o o o o o o o o o o o o o w
w o ! w w w w w w w w o o w o o o ! o o w o w o w w w w w ! w w o w w w w o w o w
w o w o o o o o o o w o o w o o o o o o w o o o o o o o o o o o o o o o o o w ! w
w o o o o o o o w o w o o w o w w w w w w o w o o o o o o o o o w o o o o o w o w
w o w w w w $ o o o o o o o o o o o w o o o w w w o o w w w w o w @ o o o o o o w
w o w o o o o o o o o o o w o o o o w o o o o o w o o o o o o o w w w w w w w o w
w o w o o o w o w o w o o w o w w w w o w w w o w o o o o o o o o o o o o o o o w
w ! w o w w w o w o w o o w o o o o w o o o o o w o w w w w o o o w o w w w w o w
w o o o w o o o w o w o o w o ! o o w o w o w o w o o o ! w o o o w o o o o o o w
w o w o w o o o w o o o o w o o o o w o w o o o w $ w o o w o o o w o o o o w o w
w o w o w o ) o w w w w w w o w w o w o w o w w w w w o o o o o o w o w w w w o w
w o ! w o o o o o o o o o o o o o o o w o o o o o o o o o o o o o o o o o o w w w
w w w w w w w w w w w w w w w w w w w w w w w w w w w w w w w w w w w w w w w w w
w w o o o o o o o o o o w $ o o o o w o o o o w ! w o o w o o w o o o w o o o o w
w ! o w o o ( o o o w o o o o o w o o o w o o o o o o o o w o o o w o o o @ o o w
w w o o o o o w o o o ! o o w o o o o $ o o o w o o w o o o o o o w ! w o o o o w
w o o w o w o o o o o o w o o o o w o o o w o o o o o o w w o w o o o o o o o o w
w o w w w w w w w w w w w w w w w w w w w w w w w w w w w w w w w w o w w w w w w
w ! w o o o o o o o o o o o o o o o o o o o w ! o o o o w o ! o o w o o o o o o w
w o w o o o o o o o w o w ] o o o o o o o o w o w w w o w o o o o w o o o o o o w
w o w o o o o o o o w o w o o w w w o o o o w o w ! o o w o o o $ w o o o o o o w
w o w o o o ! o o o w o w o o o ! w o o o o o o o o w w w o o o o w w o o o o o w
w o o o o o o o o o w o w o o w w w o o o o w w w w w o o o o o o ! w o o o ! o w
w o w o o o o o o o w ! w o o o o o o o o o o o o o o o o o o o o o w o o o o o w
w o w o o o o o o o w ! w o o w o w w $ o o o o o o o o o o o o o o w o o o o o w
w o w o o o o o o o w ! w o o w ! ! w o o o o o o o o o w w w w w w w o o o o o w
w o w o o o o o o o w w w o o w w w w o o o o o o o o o w ! o o o o o ] o o o o w
w o w o o @ o o o o o o o o o o o o o o o o o o o o o o w o o o o o o o o o o ? w
w w w w w w w w w w w w w w w w w w w w w w w w w w w w w w w w w w w w w w w w w